			P1	P2
ALONSO, MAXIMILIANO ADRIAN		
ARANGO, MAURICIO	10	Recup Dic, ABB
ARCE, RUBÉN EMANUEL	recup tda	
AUDINO, LEONEL	7	10
BALSAMO, MARTÍN NEHUEN	10	10
BELOTTA, IRINA ROCÍO	recup tda	Recup todo
BENITEZ, MARICEL	recup tda	
BERCAITZ, MARTÍN IGNACIO	9	Recup Dic, ABB
BIANCHI, JUAN PABLO	recup recu	Recup todo
BRAVO, MARIO ALVARO FABRICIO	10	10
BREME, FEDERICO JOSE	10	10
BRUMATTI, GIULIANO NICOLAS	10	Recup Abb
CALDERON, CARLOS ARIEL	8	Recup ABB
CALDERON, LUANA	recup tda	Recup todo
CALVO, LUCIANA GUADALUPE		
CANTERO, FERNANDO	10	10
CASCO, THOMAS SANTIAGO	8	
CASTELLI, ALAN NAHUEL		
CASTRO BEILICKE, LUCIA ABRIL	8	Recup todo
CASTRO, SEBASTIAN	10	Recup Dic, ABB
CHAVEZ, EMANUEL IGNACIO		
CHAVEZ, FACUNDO NAHUEL	recup todo	
COLOMBANO, FRANCO	10	Recup Dic
CREVATIN, ELIAS	recup todo	
CRUSVAR, LUCAS	recup tda	Recup todo
DENHOFF, LORENA SOLEDAD		
DI NAPOLI, AGOSTINA	8	Recup todo
DI NAPOLI, RENZO	recup todo	
DI PIETRO, LEANDRO ARIEL	10	Recup Dic, ABB
DI TUCCI, SEBASTIÁN	10	10
DIEGUEZ, MARCOS MISAEL	recup todo	
DOVAL, MONICA SELVA	10	10
D´AMORE, ZOE ABIGAIL		
DÍAZ, LAUTARO BLAS	recup tda	Recup Dic, ABB
ESCALANTE, CARLA BELÉN	10	Recup Dic, ABB
FAIGENBOIM, DANIEL ALBERTO	7	Recup Listas, ABB
FAVILLI, PABLO MARTIN	10	Recup todo
Fontivero, Agustina	recup todo	
GALEANO, ROBERTO CARLOS	8	Recup Dic
GERACE, CESAR EMILIANO	10	Recup Dic
GIORDA, ALEXIS DARÍO	7	Recup Dic
GODOY, MICAELA		
GONZALEZ, FEDERICO EZEQUIEL	recup tda	Recup todo
GUEVARA, GUILLERMO	recup todo	
GUTIERREZ, GABRIEL FACUNDO		
HERRERA, ERIC RAUL LEONEL	10	Recup Dic
Herold, Iván Ezequiel	10	10
LENIS, JONATHAN	10	Recup Dic, Listas
LOIACONO, NAHUEL DAMIAN	7	Recup Dic
LOPEZ VALLEJOS, MACARENA BELÉN	recup tda	
MARCHESE, XIMENA CIELO	10	Recup Dic, Listas
MARINOZZI, FRANCO	9	10
MEZA, TOMÁS LUCIANO	recup todo	
MURUAGA, BRANKO GABRIEL	10	10
Martinez, Andrés	10	Recup Listas, ABB
NUÑEZ, ARIEL MARTÍN	10	10
NUÑEZ, MANUEL ISAIAS	9	10
OLIVA, IVAN URIEL	recup todo	
OLIVERA, LAUTARO BENJAMÍN	9	10
OVEJERO, FERNANDO JULIO	recup todo	
PACHECO, CESAR AUGUSTO	10	8
PAGLIARULO, ROCÍO YASMIN	10	10
PALLERO, KEVIN ALEJANDRO	recup tda	
PASQUALI, AGUSTÍN LUIS	recup todo	Recup Listas
PEDROS, PABLO MAURICIO	8	Recup todo
PRIMERA SILVA, DIEGO PRIMERA	recup tda	Recup todo
RENE, IGNACIO DANIEL	10	10
RIOS, BRAIAN EZEQUIEL	4	Recup todo
RODRIGUEZ, ALAN DAVID	9	Recup Dic
RODRIGUEZ, ROXANA STEPHANIE	10	Recup ABB
RORATO, CRISTIAN		
SCHEFER, DIEGO ALBERTO	recup todo	
SEBOK, RODRIGO MARTIN	9	10
SEOANE, MAGALI ELIZABETH	9	10
SOLARI, SANTIAGO IVÁN	8	Recup Listas
SOLIS DIAZ, JUAN MANUEL	recup todo	
Schmidt, Juan Ignacio	9	Recup Lista, ABB
TABAKA, LUCA URIEL	9	Recup Dic
TESAR MOLINA, JULIETA	recup tda	Recup ABB
TRONCOSO, TOMAS PABLO	8	Recup todo
Vai, Thomas	recup tda	Recup Dic
Ybarra, Gabriel Leandro	recup tda	